#-########
#--------#
#----###-#
###-#----#
##----#--#
########-#
