#-########
#--------#
#-######-#
#-#------#
#-#-######
#---#----#
########-#